1111111111111111
1P0100000000C001
1101010101110101
1C0001C10000E1C1
1111111111111111