1111111111111111
1P0100000000C001
1101010101111011
1C0001C10000E0C1
1111111111111111
1111111111111111
1111111111111111